#######
#.....#
###.#.#
###.###
###.###
#....X#
####### 